Hello World
isatty->判断一个文件描述符引用的是否是一个终端
ttyname->获取一个终端的名称
Passing File Descriptors->传递文件描述符
Sshpass->sshpass工具注解
pty->伪终端
forkptytest->伪终端示例程序forkpty
ptytest->伪终端示例程序ptytest
Test Container Reboot->判断内核支持容器重启
Real Time Signal->实时信号
Signalfd Demo->用文件描述符来接收信号
Unix Socket->Unix域套接字
Abstract Unix Socket->Unix域抽象套接字
setjmp and longjmp->函数间跳转setjmp和longjmp
clone parent->CLONE_PARENT示例程序
setgroups getgroups->get/set list of supplementary group IDs
initgroups->initialize the supplementary group access list
pipes simple pipe->using a pipe to communicate between a parent and a child process
pipes pipe sync->Using a pipe to synchronize multiple process
pipes ls wc->Using a pipe to connect ls and wc
pipes popen glob->Globbing filename patterns with popen()
pipes fifo seqnum->Using FIFOs in a single-server and multiple-client application
pgsjc setsid->Create a new session
pgsjc catch sighup->Handling of SIGHUP by the shell
pgsjc disc sighup->SIGHUP and termination of the controlling process
Regular Expression Matching->正则表达式使用方法
Seccomp Autodetect->01-检测系统是否支持seccomp特性
Seccomp Example->02-使用简单的seccomp filters
Seccomp API->03-Linux系统调用seccomp
libseccomp->04-Libseccomp用法
no new privs->NO_NEW_PRIVS总结
jsmn->一个简单的JSON解析程序
backtrace->程序自我DEBUG方法
